*************
*EEEEEEEEEEE*
*           *
*           *
*S          *
*************