*****
*S  *
*** *
*   *
* ***
*  E*
*****