***************
*S            *
************* *
*           * *
* ********* * *
* *E        * *
* *********** *
*             *
***************