*********************************
*                               *
* ***************************** *
* *                             *
* * ***************** ********* *
* * *             *           * *
* * * ******* ********* ***** * *
* * * * *   *     * *   *     * *
* * * * * * ***** * * *** ***** *
* * * *   * *   *   * *       * *
* * * * *** * * *** * ******* * *
* * * *   * * *   *   *       * *
* * * *** * * *** ***** ******* *
* * *     * * *       *     * * *
* * ******* * ******* ***** * * *
* * *   *   * *     *       * * *
* * * * *** * * * * ********* * *
* * * *   * * *E  *     *     * *
* * * *** * * ******* *** * * * *
* * * *   *   *     *   * * * * *
* * * * *** ***** * *** * *** * *
* * * *     *   * *   *       * *
* * * ******* * * *** *** *** * *
* * *       * * *   *   *   * * *
* * ******* * * *** *** *** * * *
* * *       * * *     *   *   * *
* * * ******* * ***** *** *** * *
*   * *       * *       *   * * *
* * * ******* * ******* *** * * *
* * *         *         *     * *
* * *************************** *
*S*                             *
*********************************